Your name is Rex, the family dog. Today is a special day! Many people are here visiting your humans, and thre are lots of tasty smells. Hmm... How can you get something to eat?

Turkey Quest
An Interactive Fiction by Git
Release 1 / Serial number 200421 / Inform 7 build 6M62 (I6/v6.34 lib 6/12N) SD

Example Location

>look
Example Location

>north
You can't go that way.

>west
You can't go that way.

>south
You can't go that way.